11111111111111111111111111111111111111111111111111111111111111111111111111111111111111
10000000000001000000000000000000000000000000000000000011001111111111111111111111111111
10011111111111111111111111111111111111111111111111111111001111111111111111111111111111
10011111111111111111111111000000000000000000000000000001000000000011111111111111111111
10010000000000000000000001000001111111111111111111111111000000000011111111111111111111
10010000000000000000000001000001111111111111111111111111111111110011111111111111111111
10011111111111111111111111000001111111111111111111111111111111110011111111111111111111
10010000000000100000000001000001000000000000000000000000000000110011111111111111111111
10010000000000100000000111000001000000000000000000000000000000110011111111111111111111
10010011111100100111111111000001001100000000000000000000000000110011111111111111111111
10010010000100100100001111000001001100000000000000000000000000110011111111111111111111
10010010000100100100001001000001001100000000000000000000000000110011111111111111111111
10010010000100100100001001000001001100000000000000000000000000110011111111111111111111
10010010000100100100001001000001001100000000000000000000000000110011111111111111111111
10010011111100100111111001000001001100000000000000000000000000110011111111111111111111
10010000000000100000000001000001001100000000000000000000000000000011111111111111111111
10010000000000100000000001000001001100000000000000000000000000000011111111111111111111
10011111111111111111111111000001001111111111111111111111111111111111111111111111111111
10010000000000100000000001000001001111111111111111111111111111111111111111111111111111
10010000000000100000000001000001001111111111111111111111000000000000000000001111111111
10010011111100100000000001000001001111111111111111111111000000000000000000001111111111
10010010000100100000000001000001001111111111111111111111001111111111111111001111111111
10010010000100100000000001000001001111111111111111111111001111110000000011001111111111
10010010000100100000000001000001001111111111111111111111001111110000000011001111111111
10010010000100100000000001001111001111111111111111111111001111110011110011001111111111
10010011111100100000000001001001001000000000011111111111001111110011110011001111111111
10010000000000100000000001001001001000000000011111111111001111110011110011001111111111
10010000000000100000000001001001001001111111111111111111001111110011110011001111111111
10011111111111111111111111111001001001111111111111111111001111110011110011001111111111
10000000000000000000000000000001001001111110011111111100000000000000110011001111111111
10000000000000000000000000000001001001111110011111111100000000000000110011001111111111
11111111111111111111111111111111001001111110011111111100000000000000110011001111111111
11110000000000100000000001111111001001111110011111111100000000000000110011001111111111
11110000000000100000000001111111001000000000011111111100000000000000110011001111111111
11110011111100100111111001111111001000000000011111111100000000000000110011001111111111
11110010000100100100001001111111001111111111111111111111111000011111110011001111111111
11110010000100100100001001111111001111111111111111111111111100111111110011001111111111
11110010000100100100001001111111000000000000000000000000000000111111110011001111111111
11110010000100100100001001111111000000000000000000000000000000111111110011001111111111
11110011111100100111111001111111111111111111111111111111111111111111110011001111111111
11110000000000100000000001111111111111111111111111111111111111111111110011001111111111
11110000000000100000000001111111111111111111111111111111111111111111110011001111111111
11111111111111111111111111111111111111111111111111111111111111111111110011001111111111
11111111111111111111111111111111111111111111111111111111111111111111110011001111111111
11111111111111111111111111111111111111111111111111111111111111111111110011001111111111
11111111111111111111111111111111111111111111111111111111111111111111110011001111111111
11111111111111111111111111111111111111111111111111111111111111111111110011001111111111
11111111111111111111111111111111111111111111111111111111111111111111110011000000111111
11111111111111111111111111111111111111111111111111111111111111111111110011000000111111
11111111111111111111111111111111111111111111111111111111111111111111110011111111111111
11111111111111111111111111111111111111111111111111111111111111111111110011111111111111
11111111111111111111111111111111111111111111111111111111111111111111110000001111111111
11111111111111111111111111111111111111111111111111111111111111111111110000001111111111
11111111111111111111111111111111111111111111111111111111111111111111111111111111111111
