11111111111111111111111111111111111111111111111111111111111111111111111111111111111111111111111111111111111111111111111111111111111111111111111111111111111111111111111111111111111111111111111111111111111111111
11111111111110111111111111111111111111101111111111111111111111111011111111111111111111111110111111111111111111111111101111111111111111111111111011111111111111111111111110111111111111111111111111101111111111111
11000000000000000000000001110000000000000000000000011100000000000000000000000111000000000000000000000001110000000000000000000000011100000000000000000000000111000000000000000000000001110000000000000000000000011
11000000000000000000000001110000000000000000000000011100000000000000000000000111000000000000000000000001110000000000000000000000011100000000000000000000000111000000000000000000000001110000000000000000000000011
11000000000000000000000001110000000000000000000000011100000000000000000000000111000000000000000000000001110000000000000000000000011100000000000000000000000111000000000000000000000001110000000000000000000000011
11000000000000000000000001110000000000000000000000011100000000000000000000000111000000000000000000000001110000000000000000000000011100000000000000000000000111000000000000000000000001110000000000000000000000011
11000000000000000000000001110000000000000000000000011100000000000000000000000111000000000000000000000001110000000000000000000000011100000000000000000000000111000000000000000000000001110000000000000000000000011
11000000000000000000000001110000000000000000000000011100000000000000000000000111000000000000000000000001110000000000000000000000011100000000000000000000000111000000000000000000000001110000000000000000000000011
11000000111111111110000001110000001111111111100000011100000011111111111000000111000000111111111110000001110000001111111111100000011100000011111111111000000111000000111111111110000001110000001111111111100000011
11000000100000000010000001110000001000000000100000011100000010000000001000000111000000100000000010000001110000001000000000100000011100000010000000001000000111000000100000000010000001110000001000000000100000011
11000000100000000010000001110000001000000000100000011100000010000000001000000111000000100000000010000001110000001000000000100000011100000010000000001000000111000000100000000010000001110000001000000000100000011
11000000100000000010000001110000001000000000100000011100000010000000001000000111000000100000000010000001110000001000000000100000011100000010000000001000000111000000100000000010000001110000001000000000100000011
11000000100000000010000001110000001000000000100000011100000010000000001000000111000000100000000010000001110000001000000000100000011100000010000000001000000111000000100000000010000001110000001000000000100000011
10000000100000000010000000100000001000000000100000001000000010000000001000000010000000100000000010000000100000001000000000100000001000000010000000001000000010000000100000000010000000100000001000000000100000001
11000000100000000010000001110000001000000000100000011100000010000000001000000111000000100000000010000001110000001000000000100000011100000010000000001000000111000000100000000010000001110000001000000000100000011
11000000100000000010000001110000001000000000100000011100000010000000001000000111000000100000000010000001110000001000000000100000011100000010000000001000000111000000100000000010000001110000001000000000100000011
11000000100000000010000001110000001000000000100000011100000010000000001000000111000000100000000010000001110000001000000000100000011100000010000000001000000111000000100000000010000001110000001000000000100000011
11000000100000000010000001110000001000000000100000011100000010000000001000000111000000100000000010000001110000001000000000100000011100000010000000001000000111000000100000000010000001110000001000000000100000011
11000000111111111110000001110000001111111111100000011100000011111111111000000111000000111111111110000001110000001111111111100000011100000011111111111000000111000000111111111110000001110000001111111111100000011
11000000000000000000000001110000000000000000000000011100000000000000000000000111000000000000000000000001110000000000000000000000011100000000000000000000000111000000000000000000000001110000000000000000000000011
11000000000000000000000001110000000000000000000000011100000000000000000000000111000000000000000000000001110000000000000000000000011100000000000000000000000111000000000000000000000001110000000000000000000000011
11000000000000000000000001110000000000000000000000011100000000000000000000000111000000000000000000000001110000000000000000000000011100000000000000000000000111000000000000000000000001110000000000000000000000011
11000000000000000000000001110000000000000000000000011100000000000000000000000111000000000000000000000001110000000000000000000000011100000000000000000000000111000000000000000000000001110000000000000000000000011
11000000000000000000000001110000000000000000000000011100000000000000000000000111000000000000000000000001110000000000000000000000011100000000000000000000000111000000000000000000000001110000000000000000000000011
11000000000000000000000001110000000000000000000000011100000000000000000000000111000000000000000000000001110000000000000000000000011100000000000000000000000111000000000000000000000001110000000000000000000000011
11111111111110111111111111111111111111101111111111111111111111111011111111111111111111111110111111111111111111111111101111111111111111111111111011111111111111111111111110111111111111111111111111101111111111111
11111111111111111111111111111111111111111111111111111111111111111111111111111111111111111111111111111111111111111111111111111111111111111111111111111111111111111111111111111111111111111111111111111111111111111
