1111111111111111111111111111111111111111111111111111111111111111111111111111111111111111111111111111111111111111111111111111111111111111111111111111111111111111111111111111111111111111111111111
1111111111110111111111111111111111110111111111111111111111110111111111111111111111110111111111111111111111110111111111111111111111110111111111111111111111110111111111111111111111110111111111111
1100000000000000000000011100000000000000000000011100000000000000000000011100000000000000000000011100000000000000000000011100000000000000000000011100000000000000000000011100000000000000000000011
1100000000000000000000011100000000000000000000011100000000000000000000011100000000000000000000011100000000000000000000011100000000000000000000011100000000000000000000011100000000000000000000011
1100000000000000000000011100000000000000000000011100000000000000000000011100000000000000000000011100000000000000000000011100000000000000000000011100000000000000000000011100000000000000000000011
1100000000000000000000011100000000000000000000011100000000000000000000011100000000000000000000011100000000000000000000011100000000000000000000011100000000000000000000011100000000000000000000011
1100000000000000000000011100000000000000000000011100000000000000000000011100000000000000000000011100000000000000000000011100000000000000000000011100000000000000000000011100000000000000000000011
1100000000000000000000011100000000000000000000011100000000000000000000011100000000000000000000011100000000000000000000011100000000000000000000011100000000000000000000011100000000000000000000011
1100000011111111100000011100000011111111100000011100000011111111100000011100000011111111100000011100000011111111100000011100000011111111100000011100000011111111100000011100000011111111100000011
1100000010000000100000011100000010000000100000011100000010000000100000011100000010000000100000011100000010000000100000011100000010000000100000011100000010000000100000011100000010000000100000011
1100000010000000100000011100000010000000100000011100000010000000100000011100000010000000100000011100000010000000100000011100000010000000100000011100000010000000100000011100000010000000100000011
1100000010000000100000011100000010000000100000011100000010000000100000011100000010000000100000011100000010000000100000011100000010000000100000011100000010000000100000011100000010000000100000011
1000000010000000100000001000000010000000100000001000000010000000100000001000000010000000100000001000000010000000100000001000000010000000100000001000000010000000100000001000000010000000100000001
1100000010000000100000011100000010000000100000011100000010000000100000011100000010000000100000011100000010000000100000011100000010000000100000011100000010000000100000011100000010000000100000011
1100000010000000100000011100000010000000100000011100000010000000100000011100000010000000100000011100000010000000100000011100000010000000100000011100000010000000100000011100000010000000100000011
1100000010000000100000011100000010000000100000011100000010000000100000011100000010000000100000011100000010000000100000011100000010000000100000011100000010000000100000011100000010000000100000011
1100000011111111100000011100000011111111100000011100000011111111100000011100000011111111100000011100000011111111100000011100000011111111100000011100000011111111100000011100000011111111100000011
1100000000000000000000011100000000000000000000011100000000000000000000011100000000000000000000011100000000000000000000011100000000000000000000011100000000000000000000011100000000000000000000011
1100000000000000000000011100000000000000000000011100000000000000000000011100000000000000000000011100000000000000000000011100000000000000000000011100000000000000000000011100000000000000000000011
1100000000000000000000011100000000000000000000011100000000000000000000011100000000000000000000011100000000000000000000011100000000000000000000011100000000000000000000011100000000000000000000011
1100000000000000000000011100000000000000000000011100000000000000000000011100000000000000000000011100000000000000000000011100000000000000000000011100000000000000000000011100000000000000000000011
1100000000000000000000011100000000000000000000011100000000000000000000011100000000000000000000011100000000000000000000011100000000000000000000011100000000000000000000011100000000000000000000011
1100000000000000000000011100000000000000000000011100000000000000000000011100000000000000000000011100000000000000000000011100000000000000000000011100000000000000000000011100000000000000000000011
1111111111110111111111111111111111110111111111111111111111110111111111111111111111110111111111111111111111110111111111111111111111110111111111111111111111110111111111111111111111110111111111111
1111111111111111111111111111111111111111111111111111111111111111111111111111111111111111111111111111111111111111111111111111111111111111111111111111111111111111111111111111111111111111111111111

