1111111111111111111111111111111111111111111111111111111111111111111111111111111
1000000000000100000000000010000000000001000000000000100000000000010000000000001
1000000000000100000000000010000000000001000000000000100000000000010000000000001
1011111111100100111111110010011111111001001111111100100111111110010011111111001
1011000000100100100000010010010000001001001000000100100100000010010010000001001
1011000000100100100000010010010000001001001000000100100100000010010010000001001
1011000000100100100000010010010000001001001000000100100100000010010010000001001
1011000000100100100000010010010000001001001000000100100100000010010010000001001
1011000000100100100000010010010000001001001000000100100100000010010010000001001
1011000000100100100000010010010000001001001000000100100100000010010010000001001
1011111111100100111111110010011111111001001111111100100111111110010011111111001
1011100000000100000000000010000000000001000000000000100000000000010000000000001
1011100000000100000000000010000000000001000000000000100000000000010000000000001
1111111111111111111111111111111111111111111111111111111111111111111111111111111
1000000000000100000000000010000000000000000000000000100000000000010000000000001
1000000000000100000000000010000000000000000000000000100000000000010000000000001
1001111111100100111111110010010000002222222000000100100111111110010011111111001
1001000000100100100000010010010000002222222000000100100100000010010010000001001
1001000000100100100000010010010020002222222000200100100100000010010010000001001
1001000000100100100000010010010020002222222000200100100100000010010010000001001
1001000000100100100000010010010020002222222000200100100100000010010010000001001
1001000000100100100000010010010020002222222000200100100100000010010010000001001
1001000000100100100000010010010000002222222000000100100100000010010010000001001
1001111111100100111111110010010000002222222000000100100111111110010011111111001
1000000000000100000000000010000000000000000000000000100000000000010000000000001
1000000000000100000000000010000000000000000000000000100000000000010000000000001
1111111111111111111111111111111111111111111111111111111111111111111111111111111
1000000000000000000000000010000000000001000000000000100111111000010000111111111
1000000000000000000000000010000000000001000000000000100111111000010000111111111
1001111111100000222222210010011111111001001111111100100111111110010011111111111
1001000000100000222222210010010000001001001000000100100100000010010010000001111
1001000000100000222222210010010000001001001000000100100100000010010010000001111
1001000000100000222222210010010000001001001000000100100100000010010010000001111
1001000000100000222222210010010000001001111000000100100100000010010010000001111
1001000000100000222222210010010000001001111000000100100100000010010010000001111
1001000000100000222222210010010000001001111000000100100100000010010010000001001
1001111111100000111111110010011111111001111111111100100111111110010011111111001
1000000000000000000000000010000000011001000000000000100000000000010000000000001
1000000000000000000000000010000000011001000000000000100000000000010000000000001
1111111111111111111111111111111111111111111111111111111111111111111111111111111
1000000001100100000000000010000001000001000000000000100000000000010000000000111
1000000001100100000000000010000001000001000000000000100000000000010000000000111
1001111111100111111111110010011111111001001111111111111111111111111111111111111
1001000000100111100000010010010000001001001000000100100100000010010000000011101
1001000000100111100000010010010000001001001000000100100100000010010000000011101
1001000000100111100000010010010000001001001000000100100100000010011111111111101
1001000000100100100000010010010000001001001000000100100100000010011110000001101
1001000000100100100000010010010000001001001000000100100100000010011110000001111
1001000000100100100000010010010000001001111000000100100100000010011111111111111
1001111111100100111111110010011111111001001111111100100111111110011111111111111
1000000000000100000000000010000001000001000000000000100000000000011111110000111
1000000000000100000000000010000001000001000000000000100000000000011111110000111
1111111111111111111111111111111111111111111111111111111111111111111111111111111
1000000000000100000000000010000000100001000000000000100000000000010000000000001
1000000000000100000000000010000000100001000000000000100000000000010000000000001
1001111111100100111111110010011111111001001111111100100111111110010011111111001
1001000000100100100000010010010000001001111000000100100100000010010010000001001
1001000000100100100000011110010000001001001000000100100100000010010010000001001
1001000000100100100000011110010000001001001000000100100100000010010010000001001
1001000000100100100000011110010000001001001000000100100100000010010010000001001
1001000000100100100000011110010000001001001000000100100100000010010010000001001
1001000000100100100000011110010000001001001000000100100100000010010010000001001
1001111111100100111111111110011111111001001111111111100111111110010011111111001
1001111110000100001111111110000000100001000000000000100000000000010000000000001
1001111110000100001111111110000000100001000000000000100000000000010000000000001
1111111111111111111111111111111111111111111111111111111111111111111111111111111
