1111111111111111111111111111111111111111111111111111111111111111111111111111111
1000000000000100000000000010000000eF000100000gHEf0001000iJGh0000010000000000001
1000000000000100000000000010000000eF000100000gHEf0001000iJGh0000010000000000001
1011111111100100111111110010011111111001001111111100100111111110010011111111001
1011000000100100100000010010010000001001001000000100100100000010010010000001001
1011000000100100100000010010010000001001001000000100100100000010010010000001001
101100000010010010000001dd10010000001DD1001000000100100100000010010010000001001
101100000010010010000001CC10010000001cc1001000000100100100000010010010000001001
10110000001bb10010000001BB10010000001001001000000100100100000010010010000001001
10110000001AA10010000001aa10010000001001001000000100100100000010010010000001001
1011111111100100111111110010011111111001001111111100100111111110010011111111001
1011100000000100000000000010000000000001000000000000100000000000010000000000001
1011100000000100000000000010000000000001000000000000100000000000010000000000001
1111111111111111111111111111111111111111111111111111111111111111111111111111111
1000Ij0000000100000000000010000000000000000000000000100000000000010000000000001
1000Ij0000000100000000000010000000000000000000000000100000000000010000000000001
1KK11111111001kk111111110010010000000000000000000100100111111110010011111111001
1ll10000001001LL100000010010010000000000000000000100100100000010010010000001001
10010000001001MM10000001001mm100000000000000000001OO1PP10000001oo1pp10000001QQ1
1001000000100100100000010010010000000000000000000100100100000010010010000001001
1001000000100100100000010010010000000000000000000100100100000010010010000001001
1001000000100100100000010010010000000000000000000100100100000010010010000001001
1001000000100100100000010010010000000000000000000100100100000010010010000001001
1001111111100100111111110010010000000000000000000100100111111110010011111111001
1000000000000100000000000010000000000000000000000000100000000000010000000000001
1000000000000100000000000010000000000000000000000000100000000000010000000000001
1111111111111111111111111111111111111111111111111111111111111111111111111111111
10000000000000000000000000100000000T000100000000t000100111111000010000111111111
10000000000000000000000000100000000T000100000000t000100111111000010000111111111
1001111111100000000000010010011111111001001111111100100111111110010011111111111
1001000000100000000000010010010000001001001000000100100100000010010010000001111
100100000010000000000001qq10010000001001001000000100100100000010010010000001111
1SS1000000100000000000010010010000001001001000000100100100000010010010000001111
1RR100000010000000000001001rr10000001001111000000100100100000010010010000001111
10010000001000000000000100100100000010011110000001UU10010000001uu10010000001111
100100000010000000000001001001000000100111100000010010010000001001WW10000001001
1001111111100000111111110010011111111001111111111100100111111110010011111111001
100000000000000000000000001000000001100100000000000010000000V000010000000v00001
100000000000000000000000001000000001100100000000000010000000V000010000000v00001
1111111111111111111111111111111111111111111111111111111111111111111111111111111
1000000001100100000000000010000001000001000000000000100Z0000000001z0A0000000111
1000000001100100000000000010000001000001YY00000000001yyZ0000000001z0A0000000111
1001111111100111111111110010011111111001001111111111111111111111111111111111111
100100000010011110000001001001000000100100100000010010010000001001a0A00000111a1
100100000010011110000001001XX10000001001xx100000010010010000001001a0B00000111d1
1ss100000010011110000001AF10010000001001001000000100100100000010011111111111101
100100000010010010000001001001000000100100100000010010010000001001111a0A0001101
100100000010010010000001001001000000100100100000010010010000001001111b0C0001111
100100000010010010000001001ww10000001001111000000100100100000010011111111111111
1001111111100100111111110010011111111001001111111100100111111110011111111111111
10000000A000010000000a00001000000100000100000000000010000000000001111111a00A111
10000000E000010000000e00001000000100000100000000000010000000000001111111c00D111
1111111111111111111111111111111111111111111111111111111111111111111111111111111
1000000A000001000000a0000010000000100001000000000000100000000000010000000000001
1000000G000001000000g0000010000000100001000000000000100000000000010000000000001
1001111111100100111111110010011111111001001111111100100111111110010011111111001
10010000001001AH10000001001ah10000001001111000000100100100000010010010000001001
1001000000100100100000011110010000001001001000000100100100000010010010000001001
10010000001af100100000011110010000001001001000000100100100000010010010000001001
100100000010010010000001111AI10000001001ai1000000100100100000010010010000001001
1001000000100100100000011110010000001001001000000100100100000010010010000001001
1001000000100100100000011110010000001001001000000100100100000010010010000001001
1001111111100100111111111110011111111001001111111111100111111110010011111111001
1001111110000100001111111110000000100001000000000000100000000000010000000000001
1001111110000100001111111110000000100001YY0000000000100000000000010000000000001
1111111111111111111111111111111111111111111111111111111111111111111111111111111
