111111111111111111111111111111111111111111111111111111111111111111111111
111111111100001111111111110000111111111111001111100000011111111111111111
111111111100001111111111110000111111111111001111100000011111111111111111
111001111100001111100111110000111110011111001111100000011111001111111111
111001111100001111100111110000111110011111001111100000011111001111111111
100000A1B000000a1D0000c1d000000E1f0000G1H0000g111000000111j0000K11111111
110000A1B000000a1D0000c1d000000E1f0000G1H0000g111000000111j0000K11111111
11100111110000111110011111000011111001111100111J00000000i111001111111111 
11100111110000111110011111000011111001111100111J00000000i111001111111111
111111111100001111111111110000111111111111001111111111111111111111111111
111111111100001111111111110000111111111111001111111111111111111111111111
111111111111111111111111111111111111111111111111111111111111111111111111
111000000111110000001111100001111100000000000011111000000000000111111111
111000000111110000001111100001111100000000000011111000000000000111111111
111000000111110000001111100001111100000000000011111000000000000111111111
111000000111110000001111100001111100000000000011111000000000000111111111
111000000111110000001110000000s11100000000000011111000000000000111111111
111000000111110000001111000000s11100000000000011111000000000000111111111
1b00000000C1F00000000e11100001111100000000000011111000000000000111111111
1b00000000C1F00000000e11100001111100000000000011111000000000000111111111
111111111111111111111111100001111100000000000011111000000000000111111111
111111111111111111111111100001111100000000000011111000000000000111111111
111111111111111111111111111111111122222222222211111222222222222111111111
11111111111111111111111111111111h00000000000000I1L00000000000000k1111111
11111111111111111111111111111111h00000000000000I1L00000000000000k1111111
111111111111111111111111111111111111111111111111111111111111111111111111
111001110000000000001111100111000000000000111110011111000000111111111111
111001110000000000001111100111000000000000111110011111000000111111111111
1l0000M1000000000000111n0000O1000000000000111p0000Q111000000111111111111
1l0000M1000000000000111n0000O1000000000000111p0000Q111000000111111111111
111001110000000000001111100111000000000000111110011111000000111111111111
111001110000000000001111100111000000000000111110011111000000111111111111
1111111100000000000011111111110000000000001111111111R00000000q1111111111
1111111100000000000011111111110000000000001111111111R00000000q1111111111
111111110000000000001111111111000000000000111111111111111111111111111111
111111110000000000001111111111000000000000111110011111111111111111111111
111111112222222222221111111111222222222222111110011111111111111111111111
111111N00000000000000m111111P00000000000000o1r0000S111111111111111111111
111111N00000000000000m111111P00000000000000o1r0000S111111111111111111111
111111111111111111111111111111111111111111111110011111111111111111111111
111111111111111111111111111111111111111111111110011111111111111111111111
111111111111111111111111111111111111111111111111111111111111111111111111
