111111111111111111111111111111111111111111111111111111111111111111111111
111111111100001111111111110000111111111111001111100000011111111111111111
111111111100001111111111110000111111111111001111100000011111111111111111
111001111100001111100111110000111110011111001111100000011111001111111111
111001111100001111100111110000111110011111001111100000011111001111111111
100000010000000010000001000000001000000100000011100000011100000011111111
110000010000000010000001000000001000000100000011100000011100000011111111
111001111100001111100111110000111110011111001110000000000111001111111111
111001111100001111100111110000111110011111001110000000000111001111111111
111111111100001111111111110000111111111111001111111111111111111111111111
111111111100001111111111110000111111111111001111111111111111111111111111
111111111111111111111111111111111111111111111111111111111111111111111111
111000000111110000001111100001111100000000000011111000000000000111111111
111000000111110000001111100001111100000000000011111000000000000111111111
111000000111110000001111100001111100000000000011111000000000000111111111
111000000111110000001111100001111100000000000011111000000000000111111111
111000000111110000001110000000011100000000000011111000000000000111111111
111000000111110000001111000000011100000000000011111000000000000111111111
100000000001000000000011100001111100000000000011111000000000000111111111
100000000001000000000011100001111100000000000011111000000000000111111111
111111111111111111111111100001111100000000000011111000000000000111111111
111111111111111111111111100001111100000000000011111000000000000111111111
111111111111111111111111111111111122222222222211111222222222222111111111
111111111111111111111111111111110000000000000000100000000000000001111111
111111111111111111111111111111110000000000000000100000000000000001111111
111111111111111111111111111111111111111111111111111111111111111111111111
111001110000000000001111100111000000000000111110011111000000111111111111
111001110000000000001111100111000000000000111110011111000000111111111111
100000010000000000001110000001000000000000111000000111000000111111111111
100000010000000000001110000001000000000000111000000111000000111111111111
111001110000000000001111100111000000000000111110011111000000111111111111
111001110000000000001111100111000000000000111110011111000000111111111111
111111110000000000001111111111000000000000111111111100000000001111111111
111111110000000000001111111111000000000000111111111100000000001111111111
111111110000000000001111111111000000000000111111111111111111111111111111
111111110000000000001111111111000000000000111110011111111111111111111111
111111112222222222221111111111222222222222111110011111111111111111111111
111111000000000000000011111100000000000000001000000111111111111111111111
111111000000000000000011111100000000000000001000000111111111111111111111
111111111111111111111111111111111111111111111110011111111111111111111111
111111111111111111111111111111111111111111111110011111111111111111111111
111111111111111111111111111111111111111111111111111111111111111111111111
