111111111111111111111111111111111111111111111
111110111111111101111111111101111111111011111
100000000011000000000011000000000110000000001
100000000011000000000011000000000110000000001
100000000011000000000011000000000110000000001
100000000011000000000011000000000110000000001
100000000011000000000011000000000110000000001
100000000011000000000011000000000110000000001
100000000011000000000011000000000110000000001
100000000011000000000011000000000110000000001
111110111111111101111111111101111111111011111
111111111111111111111111111111111111111111111
