111111111111111111111111111111111111111111111111111111111111111111111111111111111111
111111111101111111111111111111101111111111111111111101111111111111111111101111111111
100000000000000000001100000000000000000001100000000000000000001100000000000000000001
100000000000000000001100000000000000000001100000000000000000001100000000000000000001
100000000000000000001100000000000000000001100000000000000000001100000000000000000001
100000000000000000001100000000000000000001100000000000000000001100000000000000000001
100000000000000000001100000000000000000001100000000000000000001100000000000000000001
100000000000000000001100000000000000000001100000000000000000001100000000000000000001
100000000000000000001100000000000000000001100000000000000000001100000000000000000001
100000000000000000001100000000000000000001100000000000000000001100000000000000000001
100000000000000000001100000000000000000001100000000000000000001100000000000000000001
100000000000000000001100000000000000000001100000000000000000001100000000000000000001
100000000000000000001100000000000000000001100000000000000000001100000000000000000001
100000000000000000001100000000000000000001100000000000000000001100000000000000000001
100000000000000000001100000000000000000001100000000000000000001100000000000000000001
100000000000000000001100000000000000000001100000000000000000001100000000000000000001
100000000000000000001100000000000000000001100000000000000000001100000000000000000001
100000000000000000001100000000000000000001100000000000000000001100000000000000000001
100000000000000000001100000000000000000001100000000000000000001100000000000000000001
100000000000000000001100000000000000000001100000000000000000001100000000000000000001
100000000000000000001100000000000000000001100000000000000000001100000000000000000001
111111111101111111111111111111101111111111111111111101111111111111111111101111111111
111111111111111111111111111111111111111111111111111111111111111111111111111111111111
