111111111111111111111111111111111111111111
111110111111111011111111110111111111011111
100000000010000000000100000000010000000001
100000000010000000000100000000010000000001
100000000010000000000100000000010000000001
100000000010000000000100000000010000000001
100000000010000000000100000000010000000001
100000000010000000000100000000010000000001
100000000010000000000100000000010000000001
100000000010000000000100000000010000000001
111110111111111011111111110111111111011111
111111111111111111111111111111111111111111
